Last login: Fri Jun 26 10:51:26 on ttys015
handpan@handpan-no-MacBook-Pro ~ % ssh -i ~/.Downloads/raisetech-demo.pem ec2-user@3.112.227.132
Warning: Identity file /Users/handpan/.Downloads/raisetech-demo.pem not accessible: No such file or directory.
ssh: connect to host 3.112.227.132 port 22: Operation timed out
handpan@handpan-no-MacBook-Pro ~ % defaults write com.apple.finder AppleShowAllFiles TRUE
handpan@handpan-no-MacBook-Pro ~ % killall Finder　Finder
No matching processes belonging to you were found
handpan@handpan-no-MacBook-Pro ~ % killall Finder
handpan@handpan-no-MacBook-Pro ~ % defaults write com.apple.finder AppleShowAllFiles FALSE
handpan@handpan-no-MacBook-Pro ~ % ssh -i ~/.Downloads/raisetech-demo.pem ec2-user@3.112.227.132
Warning: Identity file /Users/handpan/.Downloads/raisetech-demo.pem not accessible: No such file or directory.

ssh: connect to host 3.112.227.132 port 22: Operation timed out
handpan@handpan-no-MacBook-Pro ~ % 
handpan@handpan-no-MacBook-Pro ~ % chmod 600 ~/.ssh/raisetech-demo.pem
chmod: /Users/handpan/.ssh/raisetech-demo.pem: No such file or directory
handpan@handpan-no-MacBook-Pro ~ % chmod 600 ~/.ssh/Downloads.pem
chmod: /Users/handpan/.ssh/Downloads.pem: No such file or directory
handpan@handpan-no-MacBook-Pro ~ % 
handpan@handpan-no-MacBook-Pro ~ % cd .ssh
handpan@handpan-no-MacBook-Pro .ssh % ssh -i ~/.ssh/raisetech-demo.pem ec2-user@3.112.227.132
Warning: Identity file /Users/handpan/.ssh/raisetech-demo.pem not accessible: No such file or directory.
ssh: connect to host 3.112.227.132 port 22: Operation timed out
handpan@handpan-no-MacBook-Pro .ssh % ssh -i ~/.Downloads/raisetech-demo.pem ec2-user@3.112.227.132
Warning: Identity file /Users/handpan/.Downloads/raisetech-demo.pem not accessible: No such file or directory.
